maze = """+---+---+---+---+---+---+---+---+
|       |                       |
+   +---+   +---+---+   +---+   +                        
|   |           |   |   |       |
+   +   +---+   +   +---+   +---+                              
|       |   |   |               |
+---+   +   +---+   +---+   +---+                              
|       |   |       |   |   |   |
+   +   +   +   +   +   +   +   +
|   |       |       |   |   |   |
+   +   +   +---+---+   +   +   +
|   |   |                       |
+   +   +---+---+---+---+   +   +
|   |                   |   |   |
+   +   +---+---+   +   +   +   +
|   |           |   |       |   |
+---+---+---+---+---+---+---+---+"""

